""""""""""""""""""""""""""""""""""""""""""""""""""""""""""""""""""""""""""""""""
""""""""""""""""""""""""""""""""""""""""""""""""""""""""""""""""""""""""""""""""
""""""""""###############################################################"""""""
""""""""""#         #     #            #                      #         #"""""""
""""""""""#         #     #            #       ~~~            #         #"""""""
""""""""""#         #     #            #      ~~~~~~                    #"""""""
          #         #     #            #        ~~~                     #"""""""
                    ### ########  ######          ~           #         #"""""""
~~~~~~~~~~~~~~~~~~                                            #         #"""""""
                 ~                                            #         #"""""""
~~~~~~~~~~~~~~~~ ~                                            ###########"""""""
               ~ ~                                                      #"""""""
          #    ~ ~                                  ########  ###########"""""""
""""""""""#   ~~ ~ ~                                #                   #"""""""
""""""""""#  ~~~~~~  ~                              #                   #"""""""
""""""""""#   ~~~~~~                                #                   #"""""""
""""""""""###############################################################"""""""
""""""""""""""""""""""""""""""""""""""""""""""""""""""""""""""""""""""""""""""""
""""""""""""""""""""""""""""""""""""""""""""""""""""""""""""""""""""""""""""""""
